try=essayer
people=personne;gent
passion=passion;désire
evidence=indice;preuve
entirely=entièrement;totalement
unambiguous=sans ambiguïté
many=braucoup
old=vieux;âgé
hold=tenir;contenir
ambiguous=ambigu
belif=croyance
that=ça;cela
patron=mécène
him=lui
wedding=mariage;noces
possible=possible;probable
omen=présage;signe;augure
augur=augurer;présager
deep=profond;grave
however=toutefois;comme
do=faire
always=toujours
happiness=bonheur
though=cependant
grand=imposant;majestueux
enjoys=apprécier;aimer
sure=sûr;certain
require=demander;exiger
requite=rendre;payer en retour
true=vrai
truth=vérité
just=juste;seulement
often=souvent
turn=tourner
tragedy=tragédie
crimson=pourpre
sleeves=manche
tough=dur;solide;résistant
polypropylen=polypropylène
card=carte
mesuring=mesurage;mesure
arcane=ésotérique
tin=étain
copper=cuivre
iron=fer
zinc=zinc
lead=plomb
rocket=fusée
boiler=chaudière;chauffe-eau
fire extinguisher=extincteur
boil=faire bouillir
hard=dur;difficile
tip=astuce;conseil;tuyau
fill=remplir
town=ville
shear=couper;tondre
pin=broche;épingle;goupille
spring=printemps;ressort
housing=logement;boîtier
plug=prise;prise de courant;prise éléctrique;fiche
lock=verrouiller;verrou
basically=en gros;basiquement
together=ensemble
fitted=ajusté;moulant
padlock=cadenas
shell=coquille
gathering=l'assemblée
gains=gain
until=jusqu'a
retired=retraité
line=ligne
behaviour=comportement
layer=couche
auditing=vérification des comptes
unlikely=peu probable
therefore=donc;par;conséquent
Additionally=de plus
might=il se pourrait que
aim=viser;en joue
upon=sur
law=loi
solving=résolution
rise=augmenter
behavior=comportement
setting=paramètres
perimeter=perimètre
